Disease	Disease1
Acoustic Neuroma	Acoustic Neuroma
Acral Lentiginous Melanoma	Melanoma
Acute Leukemia	Leukemia
Acute lymphoblastic leukemia	Leukemia
Acute Lymphocytic Leukemia	Leukemia
Acute myeloid leukemia	Leukemia
Acute Myeloid Leukemia	Leukemia
Acute promyelocytic leukemia	Leukemia
Acute Promyelocytic Leukemia	Leukemia
Adenoid cystic carcinoma	Adenoid cystic carcinoma
Adrenal adenoma	Adrenal adenoma
Adrenal Gland Pheochromocytoma	Adrenal Gland Pheochromocytoma
Adrenocortical Carcinoma	Adrenocortical Carcinoma
Adult B-Lymphoblastic Leukemia	Leukemia
Adult T-cell Leukemia	Leukemia
Alveolar Rhabdomyosarcoma	Alveolar Rhabdomyosarcoma
Anaplastic Large Cell Lymphoma	Anaplastic Large Cell Lymphoma
Anaplastic oligodendroglioma	Anaplastic Oligodendroglioma
Anaplastic Oligodendroglioma	Anaplastic Oligodendroglioma
Anaplastic Thyroid Carcinoma	Thyroid Cancer
Angiosarcoma	Angiosarcoma
Any cancer type	Any cancer type
Astrocytoma	Astrocytoma
Atypical chronic myeloid leukemia	Leukemia
Atypical Chronic Myeloid Leukemia	Leukemia
B cell lymphoma	B cell lymphoma
Barrett's Adenocarcinoma	Barrett's Adenocarcinoma
Basal cell carcinoma	Basal Cell Carcinoma
Basal Cell Carcinoma	Basal Cell Carcinoma
Bile Duct Adenocarcinoma	Bile Duct Adenocarcinoma
Biliary Tract Cancer	Biliary Tract Cancer
Billiary tract	Billiary tract
Bladder	Bladder Cancer
Bladder Carcinoma	Bladder Cancer
Bladder Urothelial Carcinoma	Bladder Cancer
Bone Epithelioid Hemangioma	Bone Cancer
Bone Ewing's Sarcoma	Bone Cancer
Bone Marrow Cancer	Bone Cancer
Brain Glioma	Brain Cancer
Brain Medulloblastoma	Brain Cancer
Breast adenocarcinoma	Breast Cancer
Breast Cancer	Breast Cancer
Breast Carcinoma	Breast Cancer
Breast Secretory Carcinoma	Breast Cancer
Bronchiolo-alveolar Adenocarcinoma	Bronchiolo-alveolar Adenocarcinoma
Cancer	Any cancer type
Cervical Adenocarcinoma	Cervical Cancer
Cervical Cancer	Cervical Cancer
Cervical Squamous Cell Carcinoma	Cervical Cancer
Cervix	Cervix Cancer
Cervix squamous cell	Cervix Cancer
Cholangiocarcinoma	Cholangiocarcinoma
Chordoma	Chordoma
Chronic Leukemia	Leukemia
Chronic lymphocytic leukemia	Leukemia
Chronic Lymphocytic Leukemia	Leukemia
Chronic myeloid leukemia	Leukemia
Chronic Myeloid Leukemia	Leukemia
Chronic Myelomonocytic Leukemia	Leukemia
Chronic Myeloproliferative Disease	Myeloma
Chronic Neutrophilic Leukemia	Leukemia
Chuvash Polycythemia	Chuvash Polycythemia
Clear Cell Renal Cell Carcinoma	Renal Cancer
Colon Adenocarcinoma	Colon Cancer
Colon Cancer	Colon Cancer
Colon Carcinoma	Colon Cancer
Colon Mucinous Adenocarcinoma	Colon Cancer
Colorectal adenocarcinoma	Colon Cancer
Colorectal Adenocarcinoma	Colon Cancer
Colorectal Cancer	Colon Cancer
Congenital Fibrosarcoma	Congenital Fibrosarcoma
Cutaneous melanoma	Melanoma
Dermatofibrosarcoma	Dermatofibrosarcoma
Dermatofibrosarcoma Protuberans	Dermatofibrosarcoma Protuberans
Desmoid Fibromatosis	Desmoid Fibromatosis
Diffuse Intrinsic Pontine Glioma	Diffuse Intrinsic Pontine Glioma
Diffuse Large B-cell Lymphoma	Diffuse Large B-cell Lymphoma
Endometrial Adenocarcinoma	Endometrial Cancer
Endometrial Cancer	Endometrial Cancer
Endometrial Carcinoma	Endometrial Cancer
Endometrial Hyperplasia	Endometrial Cancer
Endometrium	Endometrial Cancer
Eosinophilic chronic leukemia	Leukemia
Epithelial Ovarian Cancer	Ovarian Cancer
Epithelioid Hemangioendothelioma	Epithelioid Hemangioendothelioma
Epithelioid Inflammatory Myofibroblastic Sarcoma	Epithelioid Inflammatory Myofibroblastic Sarcoma
Erdheim-Chester histiocytosis	Erdheim-Chester histiocytosis
Esophageal Cancer	Esophageal Cancer
Esophageal Carcinoma	Esophageal Cancer
Esophagus Adenocarcinoma	Esophageal Cancer
Esophagus Squamous Cell Carcinoma	Esophageal Cancer
Essential Thrombocythemia	Essential Thrombocythemia
Estrogen-receptor Positive Breast Cancer	Breast Cancer
Ewing Sarcoma	Ewing Sarcoma
Female germ cell tumor	Female germ cell tumor
Female Reproductive Organ Cancer	Female Reproductive Organ Cancer
Fibrous histiocytoma	Fibrous histiocytoma
Follicular Lymphoma	Follicular Lymphoma
Follicular Thyroid Carcinoma	Thyroid Cancer
Ganglioglioma	Ganglioglioma
Gastric Adenocarcinoma	Gastric Cancer
Gastric Adenosquamous Carcinoma	Gastric Cancer
Gastroesophageal junction adenocarcinoma	Gastric Cancer
Gastrointestinal Neuroendocrine Tumor	Gastric Cancer
Gastrointestinal stromal	Gastric Cancer
Gastrointestinal Stromal Tumor	Gastric Cancer
Giant cell astrocytoma	Giant cell astrocytoma
Glandular Pattern Ovarian Yolk Sac Tumor	Ovarian Cancer
Glioblastoma	Glioblastoma
Glioblastoma multiforme	Glioblastoma Multiforme
Glioblastoma Multiforme	Glioblastoma Multiforme
Glioma	Glioma
Hairy-Cell leukemia	Leukemia
Hairy Cell Leukemia	Leukemia
Head an neck squamous	Head And Neck Cancer
Head And Neck Cancer	Head And Neck Cancer
Head And Neck Carcinoma	Head And Neck Cancer
Head And Neck Squamous Cell Carcinoma	Head And Neck Cancer
Hematologic Cancer	Hematologic Cancer
Hematologic malignancies	Hematologic malignancies
Hepatic carcinoma	Hepatic carcinoma
Hepatocellular Carcinoma	Hepatocellular Cancer
Hepatocellular Fibrolamellar Carcinoma	Hepatocellular Cancer
Hepatocellular Mixed Fibrolamellar Carcinoma	Hepatocellular Cancer
Her2-receptor Negative Breast Cancer	Breast Cancer
Her2-receptor Positive Breast Cancer	Breast Cancer
Hyper eosinophilic advanced snydrome	Hyper eosinophilic advanced snydrome
Inflammatory Breast Carcinoma	Breast Cancer
Inflammatory myofibroblastic	Inflammatory myofibroblastic
Inflammatory Myofibroblastic Tumor	Inflammatory Myofibroblastic Tumor
Intrahepatic Cholangiocarcinoma	Intrahepatic Cholangiocarcinoma
Invasive Bladder Transitional Cell Carcinoma	Bladder Cancer
Lagerhans cell histiocytosis	Langerhans-Cell Histiocytosis
Langerhans-Cell Histiocytosis	Langerhans-Cell Histiocytosis
Laryngeal Carcinoma	Laryngeal Cancer
Laryngeal Squamous Cell Carcinoma	Laryngeal Cancer
Leukemia	Leukemia
Liposarcoma	Liposarcoma
Lung	Lung Cancer
Lung Acinar Adenocarcinoma	Lung Cancer
Lung adenocarcinoma	Lung Cancer
Lung Adenocarcinoma	Lung Cancer
Lung Cancer	Lung Cancer
Lung Carcinoma	Lung Cancer
Lung Non-small Cell Carcinoma	Lung Cancer
Lung Small Cell Carcinoma	Lung Cancer
Lung squamous cell	Lung Cancer
Lung Squamous Cell Carcinoma	Lung Cancer
Lymphangioleiomyomatosis	Lymphangioleiomyomatosis
Lymphoid Leukemia	Leukemia
Lymphoma	Lymphoma
Lynch Syndrome	Lynch Syndrome
Male germ cell tumor	Male germ cell tumor
Malignant Anus Melanoma	Melanoma
Malignant astrocytoma	Malignant astrocytoma
Malignant Glioma	Malignant Glioma
Malignant Mesothelioma	Malignant Mesothelioma
Malignant peripheral nerve sheat tumor	Malignant Peripheral Nerve Sheath Tumor
Malignant Peripheral Nerve Sheath Tumor	Malignant Peripheral Nerve Sheath Tumor
Malignant Pleural Mesothelioma	Malignant Pleural Mesothelioma
Malignant rhabdoid tumor	Malignant rhabdoid tumor
Malignant Sertoli-Leydig Cell Tumor	Malignant Sertoli-Leydig Cell Tumor
Mantle cell lymphoma	Mantle Cell Lymphoma
Mantle Cell Lymphoma	Mantle Cell Lymphoma
Medulloblastoma	Medulloblastoma
Megakaryoblastic leukemia	Leukemia
Melanoma	Melanoma
Meningioma	Meningioma
Merkel Cell Carcinoma	Merkel Cell Carcinoma
Mesenchymal Chondrosarcoma	Mesenchymal Chondrosarcoma
Mesothelioma	Mesothelioma
Mucosal Melanoma	Melanoma
Multiple Myeloma	Myeloma
Myelodisplasic proliferative syndrome	Myeloma
Myelodisplasic syndrome	Myeloma
Myelodysplastic Syndrome	Myeloma
Myelofibrosis	Myeloma
Myeloid And Lymphoid Neoplasms With Eosinophilia And Abnormalities Of PDGFRA, PDGFRB, And FGFR1	Myeloma
Myeloma	Myeloma
Myxoid Liposarcoma	Myxoid Liposarcoma
Neuroblastoma	Neuroblastoma
Neuroendocrine	Neuroendocrine
Neuroendocrine Tumor	Neuroendocrine Tumor
Neurofibroma	Neurofibroma
Non-small cell lung	Non-small cell lung
NUT midline carcinoma	NUT Midline Carcinoma
NUT Midline Carcinoma	NUT Midline Carcinoma
Oligodendroglioma	Oligodendroglioma
Oral Squamous Cell Carcinoma	Oral Squamous Cell Carcinoma
Oropharynx Cancer	Oropharynx Cancer
Osteosarcoma	Osteosarcoma
Ovarian Cancer	Ovarian Cancer
Ovarian Carcinoma	Ovarian Cancer
Ovarian Clear Cell Carcinoma	Ovarian Cancer
Ovarian Cystadenocarcinoma	Ovarian Cancer
Ovarian Granulosa Cell Tumor	Ovarian Cancer
Ovarian Serous Carcinoma	Ovarian Cancer
Ovarian Serous Cystadenocarcinoma	Ovarian Cancer
Ovarian Sex Cord-stromal Tumours	Ovarian Cancer
Ovary	Ovarian Cancer
Pancreas	Pancreatic Cancer
Pancreas adenocarcinoma	Pancreatic Cancer
Pancreatic Adenocarcinoma	Pancreatic Cancer
Pancreatic Cancer	Pancreatic Cancer
Pancreatic Carcinoma	Pancreatic Cancer
Pancreatic Ductal Adenocarcinoma	Pancreatic Cancer
Pancreatic Ductal Carcinoma	Pancreatic Cancer
Papillary Adenocarcinoma	Papillary Adenocarcinoma
Papillary Renal Cell Carcinoma	Renal Cancer
Papillary Thyroid Carcinoma	Thyroid Cancer
Paraganglioma	Paraganglioma
Parietal Lobe Ependymoma	Parietal Lobe Ependymoma
Pediatric B-cell Acute Lymphoblastic Leukemia	Leukemia
Pediatric B-lymphoblastic Leukemia	Leukemia
Pediatric Fibrosarcoma	Pediatric Fibrosarcoma
Pediatric glioma	Pediatric glioma
Pericytoma	Pericytoma
Peripheral T-cell Lymphoma	Peripheral T-cell Lymphoma
Peritoneal Mesothelioma	Peritoneal Mesothelioma
Peutz-Jeghers Syndrome	Peutz-Jeghers Syndrome
Pilocytic Astrocytoma	Pilocytic Astrocytoma
Plexiform neurofibroma	Plexiform Neurofibroma
Plexiform Neurofibroma	Plexiform Neurofibroma
Polycythemia Vera	Polycythemia Vera
Precursor B Lymphoblastic Lymphoma/leukemia	Leukemia
Prostate adenocarcinoma	Prostate Cancer
Prostate Adenocarcinoma	Prostate Cancer
Prostate Cancer	Prostate Cancer
Prostate Carcinoma	Prostate Cancer
Pseudomyxoma Peritonei	Pseudomyxoma Peritonei
PTEN Hamartoma Tumor Syndrome	PTEN Hamartoma Tumor Syndrome
Rectum Cancer	Rectum Cancer
Renal	Renal Cancer
Renal angiomyolipoma	Renal Cancer
Renal Carcinoma	Renal Cancer
Renal Cell Carcinoma	Renal Cancer
Retinoblastoma	Retinoblastoma
Rhabdoid Cancer	Rhabdoid Cancer
Rhabdomyosarcoma	Rhabdomyosarcoma
Salivary Gland Cancer	Salivary Cancer
Salivary Gland Carcinoma	Salivary Cancer
Salivary glands	Salivary Cancer
Sarcoma	Sarcoma
Schwannoma	Schwannoma
Scrotum Paget's Disease	Scrotum Paget's Disease
Sezary's Disease	Sezary's Disease
Skin Melanoma	Melanoma
Skin Squamous Cell Carcinoma	Skin Squamous Cell Carcinoma
Small Cell Carcinoma Of The Ovary Hypercalcemic Type	Ovarian Cancer
Solid Tumor	Solid Tumor
Solid tumors	Solid Tumor
Stomach	Stomach Cancer
Stomach Cancer	Stomach Cancer
Stomach Carcinoma	Stomach Cancer
Supratentorial Glioblastoma Multiforme	Supratentorial Glioblastoma Multiforme
Synovial Sarcoma	Synovial Sarcoma
Systemic mastocytosis	Systemic Mastocytosis
Systemic Mastocytosis	Systemic Mastocytosis
T-cell Acute Lymphoblastic Leukemia	Leukemia
T-cell Large Granular Lymphocyte Leukemia	Leukemia
T-cell Leukemia	Leukemia
Thymic	Thymic
Thymic Carcinoma	Thymic Carcinoma
Thyroid	Thyroid Cancer
Thyroid Cancer	Thyroid Cancer
Thyroid carcinoma	Thyroid Cancer
Thyroid Carcinoma	Thyroid Cancer
Thyroid Hurthle Cell Carcinoma	Thyroid Cancer
Thyroid Medullary Carcinoma	Thyroid Cancer
Triple-receptor Negative Breast Cancer	Breast Cancer
Tuberous Sclerosis	Tuberous Sclerosis
Tumor Of Exocrine Pancreas	Pancreatic Cancer
Ureter Small Cell Carcinoma	Ureter Small Cell Carcinoma
Urinary tract carcinoma	Urinary tract carcinoma
Urothelial Carcinoma	Urothelial Carcinoma
Uterine Cancer	Uterine Cancer
Uterine Corpus Endometrial Carcinoma	Uterine Cancer
Uterine Corpus Serous Adenocarcinoma	Uterine Cancer
Uveal Melanoma	Melanoma
Vagina Sarcoma	Vagina Sarcoma
Von Hippel-Lindau Disease	Von Hippel-Lindau Disease
Waldenström's Macroglobulinemia	Waldenström's Macroglobulinemia
Waldenström macroglobulinemia	Waldenström macroglobulinemia
